80000003
8W1000W530
15000051
34000480
58000035
45000540
83000083
50000050
00000000
00000000
00000000
