33073077
R70R03R0
5305E075
R00R00R0
070E5030
R03R70R0
0503E050
03000700
00000000
00000000
00000000
