00005000
00003000
25351545
00002000
00045000
00503000
00015000
00004000
00025000
00000000
00000000

