3R1R8R2R
20501050
0R4R3R80
08050400
0R3R2R30
50104010
244RR885
00000000
00000000
00000000
00000000

