08883330
R3RRR8R0
R838383R
3R8F3R80
R8R38R3R
R30008R0
00000000
00000000
00000000
00000000
00000000
