00084000
00R5R000
00013000
0R40R100
035R85R0
0R10R400
00000000
00000000
00000000
00000000
00000000

