00005000
00050000
05005070
80050060
04005020
06050800
00886700
00000000
00000000
00000000
00000000

