30044002
30010020
300EE005
20000030
53423524
25000430
34300252
52000340
00000000
00000000
00000000

