77777777
70000070
70016811
70006320
70000046
88000000
43210000
61640000
00000000
00000000
00000000

