00000077
05100010
07040053
40084180
500053F5
80031830
04070054
01500070
00000033
00000000
00000000
