00023000
00312000
00123100
02312300
03123120
12312310
23123123
00000000
00000000
00000000
00000000

