22222222
40000000
03187243
08000000
00724318
00400000
00031872
00000000
00000000
00000000
00000000

