008W80000
04320000
03243000
24324000
43243200
24324000
00000000
00000000
00000000
00000000
00000000

