50700501
R0502530
040R60R0
1R000400
2038R107
R0000050
054R78R0
00000000
00000000
00000000
00000000

