80085808
80528080
5087500E
50548050
E0835005
80518000
80085800
00000000
00000000
00000000
00000000

