22200222
00202000
00133100
03080300
00833800
00252000
04100140
00000000
00000000
00000000
00000000

