00088000
00800000
03422008
33428080
31322880
33428080
03422008
00800000
00088000
00000000
00000000

